              a = LEFT
              b = blast / boat hut
              c = convert / dance
              d = RIGHT
              e = 
              f = firestorm / firewarrior hut
              g = ghost army / guard
              h = hypnotise / hut
              i = 
              j = 
              k = 
              l = lighting
              m = (swarm)
              n = (land bridge)
              o = balloon hut
              p = (swamp) / temple
              q = (earthquake)
              r = (erode)
              s = DOWN / spy hut
              t = tornado / tower
              u = 
              v = volcano
              w = UP / warrior hut
              x = 
              y = 
              z = 
              # = locate shaman
            # # = locate reincarnation site
              0 = select shaman
            1-9 = group
 CTRL       1-9 = set group
          enter = chat
SHIFT     enter = private chat
            tab = scores
 CTRL         s = screenshot
      backspace = world view
SHIFT backspace = world view (instant)
         insert = buildings panel
           home = spells panel
        page up = people panel
            F10 = show / hide panel
          space = locate alerting guard tower